####################
#o...#........#...F#
#.##.#.######.#.##.#
#.#..............#.#
#.#.##.##  ##.##.#.#
.......#GGGG#.......
#.#.##.######.##.#.#
#.#......P.......#.#
#.##.#.######.#.##.#
#F...#........#...o#
####################