####################
#o...#........#....#
#.##.#.######.#.##.#
#.#..............#.#
#.#.##.##..##.##.#.#
#......#GGGG#......#
#.#.##.######.##.#.#
#.#......P.......#.#
#.##.#.######.#.##.#
#....#........#...o#
####################
