####################
#    #        #    #
# ## # ###### # ## #
# #              # #
# # ## ##  ## ## # #
#      #GGGG#      #
# # ## ###### ## # #
# #      P       # #
# ## # ###### # ## #
#.   #        #   o#
####################