####################
#    #        #    #
# ## # ###### # ## #
# #              # #
# # ## ##  ## ## # #
#      #GGGG#      #
# # ## ###### ## # #
# #      P   .   # #
# ## # ###### # ## #
#    #        #    #
####################